R  1440 900
NO ./textures/texture1.xpm
SO ./textures/texture2.xpm
WE ./textures/texture3.xpm
EA ./textures/texture4.xpm
S  ./textures/cat1.xpm
F 255,100,0
C 225,30,0

        1111111111111111111111111
        1000000000110000000000001
        1011000001110000002000001
        1001000000000000000000001
111111111011000001110000202000001
100000000011000001110000000011111
11110000000000020000000002001
11110000000000000000000000001
110000000000000N0000000000001
10002000000000000000000000001
10000000000000000001010000001
110000011101010111110111100111
11110111 1110101 101111010001
11111111 1111111 111111111111
