11111111111111111111111
10000000000000000000001
10000000110000000000001
10000000111111111111111
10000000000000000000001
10000000011000000000001
11111111111100100000001
10000000000000000N00001
10000000000000000000001
11110000001111111111111
11110000000000000000001
10000000000000000000001
10000000011111000000001
11111111111111111111111

